4 2 -2 4 4 -3 4 -3
3 5 3 4 2 3 5 -2
4 3 2 -5 2 2 5 2
7 1 4 4 4 2 2 3
-3 2 2 4 2 5 2 5
2 -3 2 4 4 2 5 -1
6 2 2 -3 2 5 6 3
1 -2 5 4 4 2 -1 0
